00100000000010000000011000
02222000111000100011110010
00000010000001011000000100
00001111111100000110001000
01100000000001110000100000
00011111001100000111010000
00000000010001110000000110
00000111000110000100001000
01110000010000011000010000
00000100100111000001000000
00011010001000111100010000
01000000100000000001000110
00100101010010000100011000
00001010003000111111000000
00100000000010000000011000
02222000111000100011110010
00000010000001011000000100
00001111111100000110001000
01100000000001110000100000
00011111001100000111010000
00000000010001110000000110
00000111000110000100001000
01110000010000011000010000
00000100100111000001000000
00011010001000111100010000
01000000100000000001000110
00100101010010000100011000
00001010003000111111000000
00100000000010000000011000
02222000111000100011110010
00000010000001011000000100
00001111111100000110001000
01100000000001110000100000
00011111001100000111010000
00000000010001110000000110
00000111000110000100001000
01110000010000011000010000
00000100100111000001000000
00011010001000111100010000
01000000100000000001000110
00100101010010000100011000
00001010003000111111000000
00100000000010000000011000
02222000111000100011110010
00000010000001011000000100
00001111111100000110001000
01100000000001110000100000
00011111001100000111010000
00000000010001110000000110
00000111000110000100001000
01110000010000011000010000
00000100100111000001000000
00011010001000111100010000
01000000100000000001000110
00100101010010000100011000
00001010003000111111000000
00100000000010000000011000
02222000111000100011110010
00000010000001011000000100
00001111111100000110001000
01100000000001110000100000
00011111001100000111010000
00000000010001110000000110
00000111000110000100001000
01110000010000011000010000
00000100100111000001000000
00011010001000111100010000
01000000100000000001000110
00100101010010000100011000
00001010003000111111000000
00100000000010000000011000
02222000111000100011110010
00000010000001011000000100
00001111111100000110001000
01100000000001110000100000
00011111001100000111010000
00000000010001110000000110
00000111000110000100001000
01110000010000011000010000
00000100100111000001000000
00011010001000111100010000
01000000100000000001000110
00100101010010000100011000
00001010003000111111000000
00100000000010000000011000
02222000111000100011110010
00000010000001011000000100
00001111111100000110001000
01100000000001110000100000
00011111001100000111010000
00000000010001110000000110
00000111000110000100001000
01110000010000011000010000
00000100100111000001000000
00011010001000111100010000
01000000100000000001000110
00100101010010000100011000
00001010003000111111000000
00100000000010000000011000
02222000111000100011110010
00000010000001011000000100
00001111111100000110001000
01100000000001110000100000
00011111001100000111010000
00000000010001110000000110
00000111000110000100001000
01110000010000011000010000
00000100100111000001000000
00011010001000111100010000
01000000100000000001000110
00100101010010000100011000
00001010003000111111000000
00100000000010000000011000
02222000111000100011110010
00000010000001011000000100
00001111111100000110001000
01100000000001110000100000
00011111001100000111010000
00000000010001110000000110
00000111000110000100001000
01110000010000011000010000
00000100100111000001000000
00011010001000111100010000
01000000100000000001000110
00100101010010000100011000
00001010003000111111000000
00100000000010000000011000
02222000111000100011110010
00000010000001011000000100
00001111111100000110001000
01100000000001110000100000
00011111001100000111010000
00000000010001110000000110
00000111000110000100001000
01110000010000011000010000
00000100100111000001000000
00011010001000111100010000
01000000100000000001000110
00100101010010000100011000
00001010003000111111000000