10011111111111111111111111
11000000000000000000000011
11100110001100001100001111
11111111111111111111100011
11111000000000001000010011
11000001100111100001000111
11001100011000011111111111
11100001000011000000001111
13333333111111111111000011
12222000111000000011110011
11000010000011111000000111
11001111111111111111111111
11100000000000000000000011
11011100111100000111110011
11000001100001110000100111
11001110001110000100001111
11100110100000011100011111
11110000010111000001000011
11111111111111111111110011
11000011000110000011000111
10001000010000010000011111
10111113333311111111111111
10011111111111111111111111
11000000000000000000000011
11100110001100001100001111
11111111111111111111100011
11111000000000001000010011
11000001100111100001000111
11001100011000011111111111
11100001000011000000001111
13333333111111111111000011
12222000111000000011110011
11000010000011111000000111
11001111111111111111111111
11100000000000000000000011
11011100111100000111110011
11000001100001110000100111
11001110001110000100001111
11100110100000011100011111
11110000010111000001000011
11111111111111111111110011
11000011000110000011000111
00001000010000010000011111
10111113333311111111111111
10011111111111111111111111
11000000000000000000000011
11100110001100001100001111
11111111111111111111100011
11111000000000001000010011
11000001100111100001000111
11001100011000011111111111
11100001000011000000001111
13333333111111111111000011
12222000111000000011110011
11000010000011111000000111
11001111111111111111111111
11100000000000000000000011
11011100111100000111110011
11000001100001110000100111
11001110001110000100001111
11100110100000011100011111
11110000010111000001000011
01111111111111111111110010
01000011000110000011000110
00001000010000010000011110
00111113333311111111111111
10011111111111111111111111
11000000000000000000000011
11100110001100001100001111
11111111111111111111100011
11111000000000001000010011
11000001100111100001000111
11001100011000011111111111
11100001000011000000001110
13333333111111111111000010
12222000111000000011110010
11000010000011111000000110
11001111111111111111111110
11100000000000000000000010
11011100111100000111110010
11000001100001110000100110
11001110001110000100001110
11100110100000011100011110
11110000010111000001000010
11111111111111111111110010
11000011000110000011000110
10001000010000010000011110
10111113333311111111111110
10011111111111111111111110
11000000000000000000000010
11100110001100001100001110
11111111111111111111100010
11111000000000001000010010
11000001100111100001000110
11001100011000011111111110
11100001000011000000001110
13333333111111111111000010
12222000111000000011110010
11000010000011111000000110
11001111111111111111111110
11100000000000000000000011
11011100111100000111110011
11000001100001110000100111
11001110001110000100001111
11100110100000011100011111
11110000010111000001000011
11111111111111111111110011
11000011000110000011000111
10001000010000010000011111
10111113333311111111111111
10011111111111111111111111
11000000000000000000000011
11100110001100001100001111
01111111111111111111100011
01111000000000001000010011
01000001100111100001000111
01001100011000011111111111
01100001000011000000001111
03333333111111111111000011
02222000111000000011110011
01000010000011111000000111
01001111111111111111111111
01100000000000000000000011
01011100111100000111110011
01000001100001110000100111
01001110001110000100001111
01100110100000011100011111
01110000010111000001000011
01111111111111111111110011
01000011000110000011000111
00001000010000010000011111
00111113333311111111111111
10011111111111111111111111
11000000000000000000000011
11100110001100001100001111
11111111111111111111100011
11111000000000001000010011
11000001100111100001000111
11001100011000011111111111
11100001000011000000001111
13333333111111111111000011
12222000111000000011110010
01000010000011111000000110
01001111111111111111111110
01100000000000000000000010
01011100111100000111110010
01000001100001110000100110
01001110001110000100001110
01100110100000011100011110
01110000010111000001000010
01111111111111111111110010
01000011000110000011000110
00001000010000010000011110
00111113333311111111111110
10011111111111111111111110
11000000000000000000000010
11100110001100001100001110
01111111111111111111100010
01111000000000001000010010
01000001100111100001000110
01001100011000011111111110
01100001000011000000001110
03333333111111111111000010
02222000111000000011110010
01000010000011111000000110
01001111111111111111111110
01100000000000000000000010
01011100111100000111110010
01000001100001110000100110
01001110001110000100001110
01100110100000011100011110
01110000010111000001000010
01111111111111111111110010
01000011000110000011000110
00001000010000010000011110
00111113333311111111111110
10011111111111111111111110
11000000000000000000000010
11100110001100001100001110
01111111111111111111100010
01111000000000001000010010
01000001100111100001000110
01001100011000011111111110
01100001000011000000001110
03333333111111111111000010
02222000111000000011110010
01000010000011111000000110
01001111111111111111111110
01100000000000000000000010
01011100111100000111110010
01000001100001110000100111
01001110001110000100001111
01100110100000011100011111
01110000010111000001000011
01111111111111111111110011
01000011000110000011000111
00001000010000010000011111
00111113333311111111111111
10011111111111111111111111
11000000000000000000000011
11100110001100001100001111
01111111111111111111100011
01111000000000001000010011
01000001100111100001000111
01001100011000011111111111
01100001000011000000001111
03333333111111111111000011
02222000111000000011110011
01000010000011111000000111
01001111111111111111111111
01100000000000000000000011
01011100111100000111110011
01000001100001110000100111
01001110001110000100001111
01100110100000011100011111
01110000010111000001000011
01111111111111111111110011
01000011000110000011000111
00001000010000010000011111
00111113333311111111111111