10011111111111111111111110
11000000000000000000000010
11100110001100001100001110
01111111111111111111100010
01111000000000001000010010
01000001100111100001000110
01001100011000011111111110
01100001000011000000001110
03333333111111111111000010
02222000111000000011110010
01000010000011111000000110
01001111111111111111111110
01100000000000000000000010
01011100111100000111110010
01000001100001110000100110
01001110001110000100001110
01100110100000011100011110
01110000010111000001000010
01111111111111111111110010
01000011000110000011000110
00001000010000010000011110
00111113333311111111111110
10011111111111111111111110
11000000000000000000000010
11100110001100001100001110
01111111111111111111100010
01111000000000001000010010
01000001100111100001000110
01001100011000011111111110
01100001000011000000001110
03333333111111111111000010
02222000111000000011110010
01000010000011111000000110
01001111111111111111111110
01100000000000000000000010
01011100111100000111110010
01000001100001110000100110
01001110001110000100001110
01100110100000011100011110
01110000010111000001000010
01111111111111111111110010
01000011000110000011000110
00001000010000010000011110
00111113333311111111111110
10011111111111111111111110
11000000000000000000000010
11100110001100001100001110
01111111111111111111100010
01111000000000001000010010
01000001100111100001000110
01001100011000011111111110
01100001000011000000001110
03333333111111111111000010
02222000111000000011110010
01000010000011111000000110
01001111111111111111111110
01100000000000000000000010
01011100111100000111110010
01000001100001110000100110
01001110001110000100001110
01100110100000011100011110
01110000010111000001000010
01111111111111111111110010
01000011000110000011000110
00001000010000010000011110
00111113333311111111111110
10011111111111111111111110
11000000000000000000000010
11100110001100001100001110
01111111111111111111100010
01111000000000001000010010
01000001100111100001000110
01001100011000011111111110
01100001000011000000001110
03333333111111111111000010
02222000111000000011110010
01000010000011111000000110
01001111111111111111111110
01100000000000000000000010
01011100111100000111110010
01000001100001110000100110
01001110001110000100001110
01100110100000011100011110
01110000010111000001000010
01111111111111111111110010
01000011000110000011000110
00001000010000010000011110
00111113333311111111111110
10011111111111111111111110
11000000000000000000000010
11100110001100001100001110
01111111111111111111100010
01111000000000001000010010
01000001100111100001000110
01001100011000011111111110
01100001000011000000001110
03333333111111111111000010
02222000111000000011110010
01000010000011111000000110
01001111111111111111111110
01100000000000000000000010
01011100111100000111110010
01000001100001110000100110
01001110001110000100001110
01100110100000011100011110
01110000010111000001000010
01111111111111111111110010
01000011000110000011000110
00001000010000010000011110
00111113333311111111111110
10011111111111111111111110
11000000000000000000000010
11100110001100001100001110
01111111111111111111100010
01111000000000001000010010
01000001100111100001000110
01001100011000011111111110
01100001000011000000001110
03333333111111111111000010
02222000111000000011110010
01000010000011111000000110
01001111111111111111111110
01100000000000000000000010
01011100111100000111110010
01000001100001110000100110
01001110001110000100001110
01100110100000011100011110
01110000010111000001000010
01111111111111111111110010
01000011000110000011000110
00001000010000010000011110
00111113333311111111111110
10011111111111111111111110
11000000000000000000000010
11100110001100001100001110
01111111111111111111100010
01111000000000001000010010
01000001100111100001000110
01001100011000011111111110
01100001000011000000001110
03333333111111111111000010
02222000111000000011110010
01000010000011111000000110
01001111111111111111111110
01100000000000000000000010
01011100111100000111110010
01000001100001110000100110
01001110001110000100001110
01100110100000011100011110
01110000010111000001000010
01111111111111111111110010
01000011000110000011000110
00001000010000010000011110
00111113333311111111111110
10011111111111111111111110
11000000000000000000000010
11100110001100001100001110
01111111111111111111100010
01111000000000001000010010
01000001100111100001000110
01001100011000011111111110
01100001000011000000001110
03333333111111111111000010
02222000111000000011110010
01000010000011111000000110
01001111111111111111111110
01100000000000000000000010
01011100111100000111110010
01000001100001110000100110
01001110001110000100001110
01100110100000011100011110
01110000010111000001000010
01111111111111111111110010
01000011000110000011000110
00001000010000010000011110
00111113333311111111111110
10011111111111111111111110
11000000000000000000000010
11100110001100001100001110
01111111111111111111100010
01111000000000001000010010
01000001100111100001000110
01001100011000011111111110
01100001000011000000001110
03333333111111111111000010
02222000111000000011110010
01000010000011111000000110
01001111111111111111111110
01100000000000000000000010
01011100111100000111110010
01000001100001110000100110
01001110001110000100001110
01100110100000011100011110
01110000010111000001000010
01111111111111111111110010
01000011000110000011000110
00001000010000010000011110
00111113333311111111111110
10011111111111111111111110
11000000000000000000000010
11100110001100001100001110
01111111111111111111100010
01111000000000001000010010
01000001100111100001000110
01001100011000011111111110
01100001000011000000001110
03333333111111111111000010
02222000111000000011110010
01000010000011111000000110
01001111111111111111111110
01100000000000000000000010
01011100111100000111110010
01000001100001110000100110
01001110001110000100001110
01100110100000011100011110
01110000010111000001000010
01111111111111111111110010
01000011000110000011000110
00001000010000010000011110
00111113333311111111111110